1,1,1,1,1,1,1,1,1,1,1,1,1,1,1,1,1,1,1,1
1,0,0,0,4,1,1,1,1,1,0,0,0,0,1,0,0,0,0,1
1,0,12,0,0,4,1,1,1,1,0,0,0,0,1,0,0,11,0,1
1,0,0,0,0,0,4,1,1,1,0,0,0,0,0,0,6,0,0,1
1,2,0,0,0,0,0,4,1,1,0,0,0,0,0,0,0,0,0,1
1,1,2,0,0,0,0,0,4,1,0,0,1,1,1,1,1,0,6,1
1,1,1,2,0,0,0,0,0,4,6,0,1,1,1,1,1,0,0,1
1,1,1,1,2,0,0,0,0,0,0,0,0,0,0,0,0,0,0,1
1,1,1,1,1,2,0,0,0,0,0,0,0,6,0,0,0,0,0,1
1,1,1,1,1,1,2,0,0,0,0,6,0,0,0,6,0,0,0,1
1,1,1,1,1,1,1,2,0,0,0,0,0,0,0,0,0,0,0,1
1,1,1,1,1,1,1,1,1,1,1,1,1,1,1,1,1,1,1,1