1,1,1,1,1,1,1,1,1,1,1,1,1,1,1,1,1,1,1,1
1,1,0,0,0,0,0,0,0,0,0,0,0,0,0,0,0,0,4,1
1,1,0,0,0,0,0,0,0,1,1,1,1,1,1,1,1,1,0,1
1,1,0,12,0,0,0,0,0,1,1,0,0,0,0,0,11,1,0,1
1,1,0,0,0,0,0,0,0,1,1,0,0,0,0,0,1,1,0,1
1,1,0,0,0,0,0,0,0,1,1,0,0,0,0,0,0,0,0,1
1,1,0,0,0,0,0,0,0,1,1,0,0,0,0,0,0,0,0,1
1,1,0,0,0,0,0,0,0,1,1,0,0,0,0,0,0,0,0,1
1,1,0,0,0,0,0,0,0,1,1,0,0,0,0,0,0,0,0,1
1,1,0,0,0,0,0,0,0,1,1,0,0,0,0,0,0,0,0,1
1,1,0,0,0,0,0,0,0,0,0,0,0,0,0,0,0,0,0,1
1,1,1,1,1,1,1,1,1,1,1,1,1,1,1,1,1,1,1,1