1,1,1,1,1,1,1,1,1,1,1,1,1,1,1,1,1,1,1,1
1,0,0,0,0,0,0,1,6,6,6,6,1,0,0,0,0,0,0,1
1,0,6,0,0,0,0,1,0,0,0,0,1,0,5,2,0,0,0,1
1,0,0,0,0,6,0,0,0,0,0,0,0,0,4,3,0,0,0,1
1,0,0,0,0,0,0,1,0,0,0,0,1,0,0,0,0,0,0,1
1,0,0,1,7,0,0,1,0,0,11,0,1,0,0,9,1,0,0,1
1,0,0,1,0,0,0,1,1,1,1,1,1,0,0,0,1,0,0,1
1,0,0,0,0,0,0,1,0,12,0,0,1,0,0,0,0,0,0,1
1,0,0,5,2,0,0,1,0,0,0,0,1,0,0,0,5,2,0,1
1,0,0,4,3,0,0,0,0,0,0,0,0,0,0,0,4,3,0,1
1,0,0,0,0,0,0,0,10,0,1,2,0,0,0,0,0,0,0,1
1,1,1,1,1,1,1,1,1,1,1,1,1,1,1,1,1,1,1,1