1,1,1,1,1,1,1,1,1,1,1,1,1,1,1,1,1,1,1,1
1,0,0,0,0,0,0,0,0,1,1,0,0,0,0,0,0,0,0,1
1,0,6,11,6,0,0,0,0,1,1,0,0,0,0,0,6,0,0,1
1,0,0,6,0,0,0,0,0,8,0,0,0,10,0,0,0,6,0,1
1,0,0,0,0,0,0,0,0,0,0,10,0,8,0,0,0,0,0,1
1,1,1,1,8,0,0,0,0,10,0,8,0,0,0,0,10,0,1,1
1,1,8,0,0,0,0,10,0,8,0,0,0,0,10,0,1,1,1,1
1,0,0,0,0,10,0,8,0,0,0,0,0,0,0,0,0,0,0,1
1,0,6,0,0,8,0,0,0,0,0,0,0,0,0,0,0,0,0,1
1,0,0,6,0,0,0,0,0,10,0,0,0,0,0,0,12,0,0,1
1,0,0,0,0,0,0,0,0,1,1,0,0,0,0,0,0,0,0,1
1,1,1,1,1,1,1,1,1,1,1,1,1,1,1,1,1,1,1,1