1,1,1,1,1,1,1,1,1,1,1,1,1,1,1,1,1,1,1,1
1,0,0,0,0,0,0,0,1,1,3,0,0,0,0,0,1,1,1,1
1,0,6,0,0,0,0,0,1,1,0,0,0,0,0,0,1,1,1,1
1,0,0,0,1,1,0,0,1,1,0,0,0,0,0,0,1,1,1,1
1,0,0,0,1,1,0,0,1,1,0,0,1,1,0,0,1,1,1,1
1,0,0,0,1,1,7,0,0,0,0,0,1,1,0,0,1,1,1,1
1,0,0,0,1,1,0,0,0,0,0,0,1,1,0,0,1,1,1,1
1,0,0,0,1,1,1,1,1,1,0,0,1,1,0,0,1,1,1,1
1,0,0,0,1,1,1,1,1,1,0,0,1,1,0,0,0,0,0,1
1,0,12,0,1,1,1,1,1,1,0,0,0,0,0,0,1,11,1,1
1,0,0,0,1,1,1,1,1,1,0,0,0,0,0,0,0,0,0,1
1,1,1,1,1,1,1,1,1,1,1,1,1,1,1,1,1,1,1,1