1,1,1,1,1,1,1,1,1,1,1,1,1,1,1,1,1,1,1,1
1,1,1,1,1,0,0,0,0,0,0,0,0,0,0,4,1,1,1,1
1,1,1,1,3,0,0,1,1,1,1,1,1,0,0,0,1,1,1,1
1,1,1,3,0,0,0,1,1,1,1,1,1,0,0,0,0,9,1,1
1,8,0,0,0,0,0,1,1,1,1,1,1,0,0,0,0,0,1,1
1,0,0,0,0,0,0,1,1,1,1,1,1,0,0,0,0,0,4,1
1,7,0,0,0,0,0,1,1,1,1,1,1,0,0,11,0,0,5,1
1,0,0,0,0,0,0,1,1,1,1,1,1,0,0,0,0,0,1,1
1,1,0,0,0,0,0,1,1,1,1,1,1,0,0,0,10,0,1,1
1,1,2,0,0,0,0,1,1,1,1,1,1,0,0,5,1,1,1,1
1,1,1,2,0,12,0,1,1,1,1,1,1,0,5,1,1,1,1,1
1,1,1,1,1,1,1,1,1,1,1,1,1,1,1,1,1,1,1,1